4 4
************
*.....******
*.***.....**
*.***.******
*.**....****
*.**.**.****
*....**.....
***.********
*..........*
************